Шум	N
дрели	N
наконец-то	ADV
стих	V
теперь	ADV
я	PRON
могу	V
прочитать	V
стих	N
В	PREP
дали	N
виднелись	V
тёмные	ADJ
дали	N
где	ADV
мне	PRON
дали	V
словарь	N
Даля	N
Акакий	N
любил	V
ездить	V
в	PREP
Гватемалу	N
В	PREP
городе	N
Жайрем	N
есть	V
автозаправка	N
с	PREP
названием	N
Матан	N
мунай	N
Компания	N
Росагроэкспорт	N
находится	V
в	PREP
Подмосковье	N
Андрей	N
был	V
КМС	N
по	PREP
плаванию	N
Студенты	N
любят	V
гулять	V
по	PREP
МГУ	N
Фрукты	N
отличаются	V
от	PREP
овощей	N
т	PRON
е	V
не	PART
являются	V
овощами	N
Овощи	N
это	PRON
топинамбур	N
пастернак	N
кольраби	N
и	CONJ
т	ADV
д	ADV
Пни	V
урони	V
рви	V
уничтожь	V
всё	PRON
Кивни	V
если	CONJ
ты	PRON
киви	N
Богат	ADJ
беден	ADJ
это	PRON
прилагательные	N
Нося	V
кеды	N
ты	PRON
портишь	V
ноги	N
а	CONJ
чистя	V
их	PRON
портишь	V
руки	N
Мегапроизводительный	ADJ
мясокомбинат	N
работает	V
двадцатичетырехчасовую	ADJ
смену	N
Фанат	N
кекать	V
с	PREP
мемов	N
наверное	ADV
не	PART
знает	V
что	PRON
такое	ADJ
ржач	N
Репостить	V
мои	ADJ
посты	N
разрешено	ADJ
только	ADV
фолловерам	N
Там	ADV
пушат	V
на	PREP
миде	N
а	CONJ
я	PRON
фармлю	V
Я	PRON
моюсь	V
вихоткой	N
потому	CONJ
что	CONJ
не	PART
знаю	V
о	PREP
мочалке	N
Я	PRON
люблю	V
мисо	N
суп	N
и	CONJ
занимаюсь	V
бусидо	N
икебана	N
не	PART
мое	ADJ
любимое	ADJ
занятие	N